verbs

Abide,	        Abode,	            Abiden,	            Sufrir.
Arise,	        Arose,	            Arisen,	            Surgir.
Awake,	        Awoke,	            Awoken,	            Despertar.
Be,	            Was,	            Been,	            Ser - Estar.
Bear,	        Bore,	            Born,	            Soportar.
Beat,	        Beat,	            Beaten,	            Golpear.
Becom,	        Became,	            Become,	            Convertirse.
Begin,	        Began,	            Begun,	            Empezar.
Bet,	        Bet,	            Bet,                Apostar.
Bend,	        Bent,	            Bent,	            Torcer.
Bid,	        Bid,	            Bid,	            Ofrecer.
Bind,	        Bound,	            Bound,	            Unir.
Bite,	        Bit,             	Bitten,	            Morder.
Bleed,	        Bled,	            Bled,	            Sangrar.
Blow,	        Blew,	            Blown,	            Soplar.
Break,	        Broke,	            Broken,	            Romper.
Breed,	        Bred,	            Bred,	            Criar.
Bring,	        Brought,            Brought,	        Traer.
Broadcast,	    Broadcast,	        Broadcast,	        Transmitir.
Build,	        Built,	            Built,	            Construir.
Burn,	        Burnt,	            Burnt,	            Quemar.
Burst,	        Burst,	            Burst,	            Explotar.
Buy,            Bought,	            Bought,	            Comprar.
Cast,	        Cast,	            Cast,	            Lanzar.
Catch,	        Caught,	            Caught,	            Atrapar.
Choose,	        Choset,	            Chosen,	            Elegir.
Clap,	        Clapt,	            Clapt,	            Aplaudir.
Cling,	        Clung,	            Clung,	            Agarrarse.
Clothe,	        Clad,	            Clad,	            Vestir.
Come,	        Came,	            Come,	            Venir.
Cost,	        Cost,	            Cost,	            Costar.
Creep,	        Crept,	            Crept,	            Gatear.
Cut,            Cut,                Cut,	            Cortar.
Deal,	        Dealt,	            Dealt,	            Repartir.
Dig,            Dug,                Dug,                Cavar.
Dive,	        Dove,	            Dived,	            Bucear.
Do,	            Did,                Done,	            Hacer.
Draw,	        Drew,	            Drawn,	            Dibujar.
Dream,	        Dreamt,	            Dreamt,	            Soñar.
Drink,	        Drank,	            Drunk,	            Beber.
Drive,	        Drove,	            Driven,	            Conducir.
Dwell,	        Dwelt,	            Dwelt,	            Habitar.
Eat,            Ate,                Eaten,	            Comer.
Fall,	        Fell,	            Fallen,	            Caer.
Feed,	        Fed,                Fed,                Alimentar.
Feel,	        Felt,	            Felt,	            Sentir.
Fight,	        Fought,	            Fought,	            Pelear.
Find,	        Found,	            Found,	            Encontrar.
Flee,	        Fled,	            Fled,	            Huir.
Fling,	        Flung,	            Flung,	            Arrojar.
Fly,            Flew,	            Flown,	            Volar.
Forbid,	        Forbade,            Forbidden,	        Prohibir.
Forecast,	    Forecast,           Forecast,	        Pronosticar.
Foresee,        Foresaw,            Foreseen,	        Preveer.
Foretell,	    Foretold,           Foretold,	        Predecir.
Forget,	        Forgot,	            Forgotten,	        Olvidar.
Forgive,        Forgave,            Forgiven,	        Perdonar.
Forsake,        Forsook,            Forsaken,	        Abandonar.
Freeze,	        Froze,	            Frozen,	            Congelar.
Get,            Got,                Gotten,	            Conseguir.
Give,	        Gave,	            Given,	            Dar.
Go,	            Went,	            Gone,	            Ir.
Grind,	        Ground,	            Ground,	            Moler.
Grow,	        Gre,                Grown,	            Cultivar.
Handwrite,	    Handwrote,	        Handwritten,        Escribir a mano.
Hang,	        Hung,	            Hung,	            Colgar.
Have,	        Had,                Had,                Tener.
Hear,	        Heard,	            Heard,	            Oír.
Hide,	        Hid,	            Hidden,	            Esconderse.
Hit,            Hit,	            Hit,                Golpear.
Hold,	        Held,	            Held,	            Sostener.
Hurt,	        Hurt,	            Hurt,	            Herir.
Inlay,	        Inlaid,	            Inlaid,	            Incrustar.
Input,	        Input,	            Input,	            Introducir.
Keep,	        Kept,	            Kept,	            Mantener.
Kneel,	        Knelt,	            Knelt,	            Arrodillarse.
Knit,	        Knit,	            Knit,	            Tejer.
Know,	        Knew,	            Known,	            Saber.
Lay,            Laid,	            Laid,	            Poner.
Lead,	        Led,	            Led,                Guiar.
Lean,	        Leant,	            Leant,	            Inclinarse.
Leap,	        Leapt,	            Leapt,	            Saltar.
Learn,	        Learnt,	            Learnt,	            Aprender.
Leave,	        Left,	            Left,	            Irse.
Lend,	        Lent,	            Lent,	            Prestar.
Let,            Let,	            Let,                Permitir.
Lie,            Lay,                Lain,	            Echarse.
Light,	        Lit,	            Lit,                Encender.
Lose,	        Lost,	            Lost,	            Perder.
Make,	        Made,	            Made,	            Hacer.
Mean,	        Meant,	            Meant,	            Significar.
Meet,	        Met,                Met,	            Conocer.
Melt,	        Melted,	            Molten,	            Derretir.
Mislead,        Misled,	            Misled,	            Engañar.
Mistake, 	    Mistook,            Mistaken,	        Confundir.
Misunderstand,	Misunderstood,	    Misunderstood,	    Entender mal.
Mow,            Mowed,	            Mown,	            Segar.
Overhear,	    Overheard,	        Overheard,	        Oír sin intención.
Overtake,	    Overtook,	        Overtaken,	        Sobrepasar.
Pay,            Paid,	            Paid,	            Pagar.
Prove,	        Proved,	            Proven,	            Probar.
Put,            Put,                Put,                Poner.
Quit,	        Quit,	            Quit,	            Abandonar.
Read,	        Read,	            Read,	            Leer.
Rid,         	Rid,                Rid,                Librar.
Ride,	        Rode,	            Ridden,	            Montar.
Ring,	        Rang,	            Rung,	            Llamar por teléfono.
Rise,	        Rose,	            Risen,	            Levantarse.
Run,            Ran,	            Run,                Correr.
Saw,            Sawed,	            Sawn,	            Serruchar.
Say,            Said,	            Said,	            Decir.
See,            Saw,	            Seen,	            Ver.
Seek,	        Sought,	            Sought,	            Buscar.
Sell,	        Sold,	            Sold,	            Vender.
Send,	        Sent,	            Sent,	            Enviar.
Set,            Set,	            Set,                Poner.
Sew,            Sewed,	            Sewn,	            Coser.
Shake,	        Shook,	            Shaken,	            Sacudir.
Shave,	        Shaved,	            Shaven,	            Afeitarse.
Shear,	        Shore,	            Shorn,	            Esquilar.
Shed,	        Shed,	            Shed,	            Derramar.
Shine,	        Shone,	            Shone,	            Brillar.
Shoot,	        Shot,	            Shot,	            Disparar.
Show,	        Showed,	            Shown,	            Mostrar.
Shrink,	        Shrank,	            Shrunk,	            Reducir.
Shut,	        Shut,	            Shut,	            Cerrar.
Sing,	        Sang,	            Sung,	            Cantar.
Sink,	        Sank,	            Sunk,	            Hundirse.
Sit,            Sat,	            Sat,                Sentarse.
Slay,	        Slew,	            Slai,	            Matar.
Sleep,	        Slept,	            Slept,	            Dormir.
Slide,	        Slid,	            Slid,	            Deslizarse.
Sling,	        Slung,	            Slung,	            Arrojar.
Slink,	        Slunk,	            Slunt,	            Escabullirse.
Slit,	        Slit,	            Slit,	            Rajar.
Smell,	        Smelt,	            Smelt,	            Oler.
Sneak,	        Snuck,	            Snuck,	            Moverse con cuidado.
Sow,            Sowed,	            Sown,	            Sembrar.
Speak,	        Spoke,	            Spoken,	            Hablar.
Speed,	        Sped,	            Sped,	            Acelerar.
Spell,	        Spelt,	            Spelt,	            Deletrear.
Spend,	        Spent,	            Spent,	            Gastar.
Spill,	        Spilt,	            Spilt,	            Derramar.
Spin,	        Spun,	            Spun,	            Dar vueltas.
Spit,	        Spat,	            Spat,	            Escupir.
Split,	        Split,	            Split,	            Dividir.
Spoil,	        Spoilt,	            Spoilt,	            Arruinar.
Spread,	        Spread,	            Spread,	            Extender.
Spring,	        Sprang,	            Sprung,	            Saltar.
Stand,	        Stood,	            Stood,	            Pararse.
Steal,	        Stole,	            Stolen,	            Robar.
Stick,	        Stuck,	            Stuck,	            Pegar.
Sting,	        Stung,	            Stung,	            Picar.
Stink,	        Stank,	            Stunk,	            Apestar.
Stride,	        Strode,	            Stridden,	        Dar zancadas.
Strike,	        Struck,	            Stricken,	        Golpear.
String,	        Strung,	            Strung,	            Atar.
Strive,	        Strove,	            Striven,	        Esforzarse.
Swear,          Swore,	            Sworn,	            Jurar.
Sweat,	        Sweat,	            Sweat,	            Sudar.
Sweep,	        Swept,	            Swept,	            Barrer.
Swell,	        Swelled,	        Swollen,            Hincharse.
Swim,	        Swam,	            Swum,	            Nadar.
Swing,	        Swung,	            Swung,	            Balancear.
Take,	        Took,	            Taken,	            Tomar.
Teach,	        Taught,	            Taught,	            Enseñar.
Tear,	        Tore,	            Torn,	            Desgarrar.
Tell,	        Told,	            Told,	            Decir.
Think,	        Thought,	        Thought,            Pensar.
Thrive,	        Throve,	            Thriven,	        Prosperar.
Throw,	        Threw,	            Thrown,	            Arrojar.
Thrust,	        Thrust,	            Thrust,	            Empujar con fuerza.
Tread,	        Trod,	            Trodden,	        Pisar.
Undergo,     	Underwent,	        Undergone,	        Sufrir.
Understand,  	Understood,	        Understood,	        Entender.
Undertake,	    Undertook,	        Undertaken,	        Emprender.
Upset,	        Upset,	            Upset,	            Enfadar.
Wake,	        Woke,	            Woken,	            Despertar.
Wear,	        Wore,	            Worn,	            Vestir.
Weave,	        Wove,	            Woven,	            Tejer.
Wed,            Wed,	            Wed,	            Casarse.
Weep,	        Wept,	            Wept,	            Llorar.
Wet,            Wet,	            Wet,	            Mojar.
Win,         	Won,	            Won,                Ganar.
Wind,	        Wound,	            Wound,	            Envolver.
Withdraw,	    Withdrew,	        Withdrawn,	        Sacar.
Withhold,	    Withheld,	        Withheld,	        Ocultar.
Withstand,	    Withstood,	        Withstood,	        Resistir.
Wring,	        Wrung,	            Wrung,	            Escurrir.
Write,	        Wrote,	            Written,            Escribir.
